10000000000000000000000000000000
10000000000000000000000000000000
10000000000000000000000000000000
10000000000000000000000000000000
00000000000000000000000000000000
00000000000000000000000000000000
11111110000000000000000000000000
00000000000000000000000000000000
00000000000000000000000000000000
00000000000000000000000000000000
00000001111100000000001111100000
00000000000000000000000000000000
00000000000000001100000000000000
00000000000000000000000000000000
00000000000000000000000000000000
01110000000000000000000000000011
00000000000001100000000000111111
00000000000011110000000000000000
11000000000111111000000000000000
11110000001111111100000000000000
11111111111111111111111111111111